MapdataStart
  0,  0,  0,  0,  1,  0,  0,  0,  0,  0,  0,  0,  0,  0,
  0,  0,  0,  1,  0,  0,  0,  0,  0,  0,  0,  0,  6,  0,
  0,  0,  1,  0,  0,  0,  0,  0,  0,  0,  0,  0,  0,  0,
  0,  1,  0,  0,  0,  0,  0,  0,  1,  1,  1,  0,  0,  0,
  1,  0,  0,  0,  0,  0,  0,  1,  0,  0,  1,  0,  0,  0,
  0,  0,  0,  0,  0,  0,  1,  0,  0,  0,  1,  0,  3,  0,
  0,  0,  0,  0,  0,  1,  0,  0,  2,  0,  1,  0,  0,  0,
  0,  0,  0,  0,  1,  0,  0,  0,  0,  0,  1,  1,  1,  0,
  0,  0,  0,  1,  0,  0,  0,  0,  0,  0,  1,  0,  0,  0,
  0,  0,  0,  1,  0,  0,  0,  0,0,  0,  1,  0,  0,  0,
  0,  0,  0,  1,  0,  0,  0,  0,13,  0,  1,  0,  0,  0,
  0,  0,  0,  1,  0,  0,  0,  0,13,  0,  1,  0,  0,  0,
  0,  0,  0,  1,  0,  0,  0,  0,  0,  0,  1,  0,  3,  0,
  0,  0,  0,  0,  0,  0,  0,  0,  0,  0,  1,  0,  0,  0,
  0,  5,  0,  0,  0,  0,  0,  0,  3,  0,  1,  0,  1,  1,
  0,  0,  0,  0,  0,  0,  0,  0,  0,  0,  1,  0,  0,  0,
  1,  1,  1,  1,  1,  1,  1,  1,  1,  1,  1,  0,  0,  0,
23,23,23,23,  0,  0,  0,  0,  0,  0,  0,  0,  0,  0,
23,23,23,23,  0,  0,  5,  0,  0,  0,  0,  0,  0,  0,
23,23,23,23,  0,  0,  0,  0,  0,  0,  0,  0,  0,  0,
MapdataEnd

NumberofPeopleStart
7,
NumberofPeopleEnd

PlayerdataStart
pos,1,18,
PlayerdataEnd

MissiondataStart
0,7,
1,6,
2,60,
MissiondataEnd

EndLoadFile


// ここまでしかとりあえず読まれない。

,(カンマ)を語尾につけ忘れないで！！！！


Playerdataのとこは、
pos,x,y,nex,x,y,nex,x,y,nex,x,y,nex,x,y,nex,x,y,spe,1.0f,
みたいに設定できるよ！
posは必須でほかは書かなくてもOK!
nexは最大5つまで設定できて、書いた順番に移動して最後まで行くとまた最初(pos)に戻るを繰り返す予定！
speはその移動の時のスピードだよ！何も書かなければ3.0fに設定されてるよ！

MapdataStart とかの英語のやつは、
そこからデータを読み込み始めるよっていう
区切りだから絶対消したりしないでね
もしそれで動かなくなったりしてたら呼んでね
コード5で終了してたら読み込んでる数が
おかしかったり、とりあえずこのテキストせいでの
エラーだよ

この先の読み方を変えたいから聞く
0,1,3	// このステージのミッション内容を
	// 書いて読み込ませたい。
プレイヤーがどこに配置されているかのレイヤーを用意する
1だったら最初にボールを持っている人
2だったら配置されている人
3だったら動く人パターン1
4だったら動く人パターン2

パターンをかく
3,10,13		// 3の人のパターンで、10,14までの移動を往復する
